111111111111
10100C0C00B1
1P100B0000B1
1001000C00B1
1000CBB01E01
111111111111
